#####
#P  #
# #o###
# o xx#
#######